NO ./textures/small_bluesteel.xpm
SO ./textures/small_steel.xpm
WE ./textures/small_micro.xpm
EA ./textures/small_diagonals.xpm

F 0,255,255
C 255,0,255

        1111111111111111111111111
   1    1000000000110000000000001
        1011000001110000000000001
        1001000000000000000000001
111111111011000001110000000000001
100000000011000001110111111111111
11110111111111011100000010001
11110111111111011101000010001
11000000110101011100000000001
10000000000000000001000000001
11000001110101011111000W0000111
10000000000000000001000000001
10000000000000000001000000001
10000000000000000001000000001
10000000000000000001000000001
10000000000000000001010000001
11111111111111111111111111111
