NO ./textures/small_bluesteel.xpm
EA ./textures/small_diagonals.xpm
SO ./textures/small_steel.xpm
WE ./textures/small_micro.xpm

F 0,255,255
C 255,0,255

111111111111111
100000110000011
1000001100000011
1001001100000011
1000001100011111
1000E01111100011
111111111110111
1111111111111
 
 
 
 
 
1
