NO ./textures/small_bluesteel.xpm
EA ./textures/small_diagonals.xpm
SO ./textures/small_steel.xpm
WE ./textures/small_micro.xpm

F 0,255,255
C 255,0,255

1111111 11111111
1000001 10000011
1000001 100000011
1000001 100011111
1000E01 111100011
1111111 11110111
1111111 111111
 
 
 
 
 
1
