NO ./textures/small_bluesteel.xpm
SO ./textures/small_steel.xpm
WE ./textures/small_micro.xpm
EA ./textures/small_diagonals.xpm

C 100,100,100
F 150,150,150

        1111111111111111111111111
   1    1000000000110000000000001
        1011000001110000000000D01
        1001000000000000000000001
111111111011000001110000000000001
10000000001100000111011111D1111111
11110111111111011100000010001
11110111111111011101010010001
11000000110101011100000000001
10000000000000000001010000001
11000001110101011111011110N0111
11110111 1110101 101111010001
11111111 1111111 111111111111
